# Dữ liệu cho Bản đồ 2
[MAP_2]
layout
0 0 0 0 0 0 0 0 0 0 0 0 0 0 0 0 0 0 0 0 0 0 0 0 0 0 0 0 0 0 0 0
0 0 0 0 0 0 0 0 0 0 0 0 0 0 0 0 0 0 0 0 0 0 0 0 0 0 0 0 0 0 0 0
0 0 0 0 0 0 0 0 0 0 0 0 0 0 0 0 0 0 0 0 0 0 0 0 0 0 0 0 0 0 0 0
60 56 20 20 56 20 60 56 60 20 60 56 20 20 56 56 60 20 56 60 20 56 20 20 56 60 20 8 0 0 0 0
2 3 5 24 2 2 5 3 24 3 5 5 2 3 24 5 3 2 2 24 3 2 5 24 3 3 1 16 0 0 0 0
0 0 0 0 0 0 0 0 0 0 0 0 0 0 0 0 0 0 0 0 0 0 0 0 0 0 29 17 0 0 0 0
0 0 0 0 0 0 0 0 0 0 0 0 0 0 0 0 0 0 0 0 0 0 0 0 0 0 22 16 0 0 0 0
0 0 0 0 0 0 0 0 0 0 0 0 0 0 0 0 0 0 0 0 0 0 0 0 0 0 13 16 0 0 0 0
0 0 0 0 6 20 56 60 56 56 20 60 56 20 60 56 20 60 60 56 20 60 56 20 56 60 1 17 0 0 0 0
0 0 0 0 29 1 2 3 5 24 2 2 5 3 5 24 24 3 5 2 3 2 24 5 3 2 5 28 0 0 0 0
0 0 0 0 50 16 0 0 0 0 0 0 0 0 0 0 0 0 0 0 0 0 0 0 0 0 0 0 0 0 0 0
0 0 0 0 13 17 0 0 0 0 0 0 0 0 0 0 0 0 0 0 0 0 0 0 0 0 0 0 0 0 0 0
0 0 0 0 22 17 0 0 0 0 0 0 0 0 0 0 0 0 0 0 0 0 0 0 0 0 0 0 0 0 0 0
0 0 0 0 50 1 20 60 56 20 60 60 20 56 20 56 60 20 56 60 60 56 20 60 56 20 20 60 56 20 56 60
0 0 0 0 22 2 5 3 24 24 3 5 2 24 3 2 5 2 3 5 24 24 3 2 5 5 2 24 3 5 3 24
0 0 0 0 0 0 0 0 0 0 0 0 0 0 0 0 0 0 0 0 0 0 0 0 0 0 0 0 0 0 0 0
0 0 0 0 0 0 0 0 0 0 0 0 0 0 0 0 0 0 0 0 0 0 0 0 0 0 0 0 0 0 0 0
0 0 0 0 0 0 0 0 0 0 0 0 0 0 0 0 0 0 0 0 0 0 0 0 0 0 0 0 0 0 0 0
endlayout
decorations
enddecorations
waves
wave 0 10 1500
wave 1 10 1000
endwaves
[/MAP_2]